train_stage2
Use AdamW

Epoch: 0
acc: 0.8171428442001343
Valid:
cls |    0     |    1     |    2     |    3     |    4     |    5     |    6     |    7     |    8     |    9     |
acc |  0.1857  |  0.6000  |  0.7429  |  0.6714  |  0.9857  |  1.0000  |  1.0000  |  1.0000  |  1.0000  |  0.9857  |
num |    28    |    77    |    70    |    82    |    74    |    79    |    72    |    71    |    75    |    72    |
Test:
prediction changing rate: 8260000000.0
cls |    0     |    1     |    2     |    3     |    4     |    5     |    6     |    7     |    8     |    9     |
num |   121    |   149    |    85    |   192    |    33    |    44    |    59    |   103    |    21    |    19    |

Epoch: 1
acc: 0.8199999928474426
Valid:
cls |    0     |    1     |    2     |    3     |    4     |    5     |    6     |    7     |    8     |    9     |
acc |  0.1714  |  0.6000  |  0.8143  |  0.6571  |  0.9857  |  1.0000  |  1.0000  |  0.9857  |  1.0000  |  0.9857  |
num |    31    |    78    |    84    |    70    |    75    |    80    |    71    |    69    |    72    |    70    |
Test:
prediction changing rate: 0.2183499080708191
cls |    0     |    1     |    2     |    3     |    4     |    5     |    6     |    7     |    8     |    9     |
num |   100    |   156    |   126    |   147    |    45    |    54    |    68    |    92    |    16    |    22    |

Epoch: 2
acc: 0.8085713982582092
Valid:
cls |    0     |    1     |    2     |    3     |    4     |    5     |    6     |    7     |    8     |    9     |
acc |  0.1143  |  0.6429  |  0.7429  |  0.6429  |  0.9857  |  0.9857  |  0.9857  |  0.9857  |  1.0000  |  1.0000  |
num |    19    |    79    |    90    |    67    |    77    |    81    |    73    |    71    |    70    |    73    |
Test:
prediction changing rate: 0.2108112965316531
cls |    0     |    1     |    2     |    3     |    4     |    5     |    6     |    7     |    8     |    9     |
num |    77    |   148    |   109    |   153    |    36    |    58    |   108    |    94    |    11    |    32    |

Epoch: 3
acc: 0.822857141494751
Valid:
cls |    0     |    1     |    2     |    3     |    4     |    5     |    6     |    7     |    8     |    9     |
acc |  0.3143  |  0.5143  |  0.7857  |  0.7714  |  0.9571  |  0.9571  |  0.9714  |  0.9857  |  1.0000  |  0.9714  |
num |    38    |    55    |    72    |   106    |    70    |    77    |    69    |    71    |    73    |    69    |
Test:
prediction changing rate: 0.32898232889517687
cls |    0     |    1     |    2     |    3     |    4     |    5     |    6     |    7     |    8     |    9     |
num |   114    |   101    |   113    |   202    |    32    |    59    |    74    |    84    |    25    |    22    |

Epoch: 4
acc: 0.8057142496109009
Valid:
cls |    0     |    1     |    2     |    3     |    4     |    5     |    6     |    7     |    8     |    9     |
acc |  0.2000  |  0.4429  |  0.8429  |  0.7143  |  0.9571  |  0.9857  |  0.9714  |  0.9571  |  1.0000  |  0.9857  |
num |    28    |    51    |    99    |    88    |    70    |    85    |    69    |    67    |    72    |    71    |
Test:
prediction changing rate: 0.18839071006140523
cls |    0     |    1     |    2     |    3     |    4     |    5     |    6     |    7     |    8     |    9     |
num |    84    |    95    |   160    |   160    |    35    |    78    |    71    |    87    |    35    |    21    |

Epoch: 5
acc: 0.837142825126648
Valid:
cls |    0     |    1     |    2     |    3     |    4     |    5     |    6     |    7     |    8     |    9     |
acc |  0.2429  |  0.7143  |  0.8571  |  0.6286  |  0.9714  |  0.9857  |  1.0000  |  0.9857  |  1.0000  |  0.9857  |
num |    29    |    86    |    82    |    70    |    75    |    74    |    70    |    71    |    70    |    73    |
Test:
prediction changing rate: 0.3085119422713153
cls |    0     |    1     |    2     |    3     |    4     |    5     |    6     |    7     |    8     |    9     |
num |    97    |   163    |   139    |   117    |    57    |    54    |    76    |    91    |    15    |    17    |

Epoch: 6
acc: 0.8199999928474426
Valid:
cls |    0     |    1     |    2     |    3     |    4     |    5     |    6     |    7     |    8     |    9     |
acc |  0.2571  |  0.5857  |  0.8571  |  0.5857  |  0.9857  |  1.0000  |  0.9714  |  1.0000  |  0.9714  |  0.9857  |
num |    40    |    62    |    92    |    67    |    78    |    81    |    68    |    71    |    69    |    72    |
Test:
prediction changing rate: 0.17349975996217346
cls |    0     |    1     |    2     |    3     |    4     |    5     |    6     |    7     |    8     |    9     |
num |   121    |   122    |   124    |   109    |    56    |    68    |    80    |   105    |    21    |    20    |

Epoch: 7
acc: 0.8157142996788025
Valid:
cls |    0     |    1     |    2     |    3     |    4     |    5     |    6     |    7     |    8     |    9     |
acc |  0.3429  |  0.6000  |  0.7143  |  0.6000  |  0.9857  |  0.9286  |  1.0000  |  1.0000  |  0.9857  |  1.0000  |
num |    50    |    70    |    69    |    66    |    73    |    75    |    74    |    74    |    70    |    79    |
Test:
prediction changing rate: 0.14188622217051328
cls |    0     |    1     |    2     |    3     |    4     |    5     |    6     |    7     |    8     |    9     |
num |   129    |   106    |    90    |   158    |    43    |    66    |    79    |   113    |    20    |    22    |

Epoch: 8
acc: 0.8357142806053162
Valid:
cls |    0     |    1     |    2     |    3     |    4     |    5     |    6     |    7     |    8     |    9     |
acc |  0.5429  |  0.6286  |  0.6571  |  0.6143  |  0.9857  |  0.9857  |  0.9714  |  1.0000  |  0.9714  |  1.0000  |
num |    77    |    70    |    60    |    63    |    74    |    71    |    68    |    72    |    71    |    74    |
Test:
prediction changing rate: 0.15170665877278072
cls |    0     |    1     |    2     |    3     |    4     |    5     |    6     |    7     |    8     |    9     |
num |   193    |   102    |    77    |   116    |    47    |    53    |    76    |   115    |    20    |    27    |

Epoch: 9
acc: 0.8157142996788025
Valid:
cls |    0     |    1     |    2     |    3     |    4     |    5     |    6     |    7     |    8     |    9     |
acc |  0.1429  |  0.6571  |  0.8286  |  0.5857  |  0.9714  |  0.9857  |  1.0000  |  0.9857  |  1.0000  |  1.0000  |
num |    19    |    77    |    94    |    64    |    75    |    76    |    72    |    72    |    73    |    78    |
Test:
prediction changing rate: 0.3526452956692027
cls |    0     |    1     |    2     |    3     |    4     |    5     |    6     |    7     |    8     |    9     |
num |    73    |   119    |   180    |   109    |    57    |    49    |    71    |   100    |    26    |    42    |

Epoch: 10
acc: 0.8100000023841858
Valid:
cls |    0     |    1     |    2     |    3     |    4     |    5     |    6     |    7     |    8     |    9     |
acc |  0.2857  |  0.5714  |  0.7429  |  0.6143  |  0.9857  |  0.9857  |  0.9857  |  0.9714  |  0.9714  |  0.9857  |
num |    39    |    60    |    75    |    72    |    86    |    76    |    79    |    69    |    69    |    75    |
Test:
prediction changing rate: 0.2669222788979764
cls |    0     |    1     |    2     |    3     |    4     |    5     |    6     |    7     |    8     |    9     |
num |   101    |    96    |   104    |   150    |    60    |    64    |    88    |    98    |    14    |    51    |

Epoch: 11
acc: 0.8171428442001343
Valid:
cls |    0     |    1     |    2     |    3     |    4     |    5     |    6     |    7     |    8     |    9     |
acc |  0.2571  |  0.5143  |  0.8429  |  0.6429  |  0.9714  |  1.0000  |  0.9857  |  0.9714  |  0.9857  |  1.0000  |
num |    32    |    64    |    89    |    76    |    74    |    77    |    70    |    70    |    70    |    78    |
Test:
prediction changing rate: 0.14116721630679585
cls |    0     |    1     |    2     |    3     |    4     |    5     |    6     |    7     |    8     |    9     |
num |    96    |   112    |   113    |   121    |    60    |    70    |    77    |    96    |    21    |    60    |

Epoch: 12
acc: 0.8528571128845215
Valid:
cls |    0     |    1     |    2     |    3     |    4     |    5     |    6     |    7     |    8     |    9     |
acc |  0.4429  |  0.6429  |  0.8143  |  0.6571  |  0.9857  |  1.0000  |  1.0000  |  0.9857  |  1.0000  |  1.0000  |
num |    58    |    70    |    72    |    64    |    71    |    74    |    75    |    72    |    72    |    72    |
Test:
prediction changing rate: 0.18413777322010613
cls |    0     |    1     |    2     |    3     |    4     |    5     |    6     |    7     |    8     |    9     |
num |   133    |   114    |    85    |   101    |    52    |    71    |    85    |   101    |    33    |    51    |

Epoch: 13
acc: 0.8185714483261108
Valid:
cls |    0     |    1     |    2     |    3     |    4     |    5     |    6     |    7     |    8     |    9     |
acc |  0.2429  |  0.6429  |  0.8000  |  0.5857  |  0.9857  |  0.9857  |  1.0000  |  0.9714  |  0.9857  |  0.9857  |
num |    38    |    74    |    79    |    69    |    76    |    79    |    73    |    68    |    71    |    73    |
Test:
prediction changing rate: 0.15179466982325926
cls |    0     |    1     |    2     |    3     |    4     |    5     |    6     |    7     |    8     |    9     |
num |   109    |   111    |    95    |   102    |    83    |    73    |    90    |    96    |    22    |    45    |

Epoch: 14
acc: 0.8171428442001343
Valid:
cls |    0     |    1     |    2     |    3     |    4     |    5     |    6     |    7     |    8     |    9     |
acc |  0.1714  |  0.6286  |  0.8143  |  0.6857  |  0.9857  |  0.9857  |  0.9286  |  0.9857  |  1.0000  |  0.9857  |
num |    23    |    61    |    93    |    89    |    75    |    78    |    66    |    70    |    71    |    74    |
Test:
prediction changing rate: 0.3103167348283423
cls |    0     |    1     |    2     |    3     |    4     |    5     |    6     |    7     |    8     |    9     |
num |   100    |    91    |   116    |   143    |    50    |    83    |    74    |    80    |    49    |    40    |

Epoch: 15
acc: 0.8299999833106995
Valid:
cls |    0     |    1     |    2     |    3     |    4     |    5     |    6     |    7     |    8     |    9     |
acc |  0.2714  |  0.5571  |  0.8143  |  0.7000  |  0.9714  |  0.9857  |  1.0000  |  1.0000  |  1.0000  |  1.0000  |
num |    39    |    62    |    81    |    86    |    70    |    76    |    70    |    71    |    73    |    72    |
Test:
prediction changing rate: 0.12909364116221272
cls |    0     |    1     |    2     |    3     |    4     |    5     |    6     |    7     |    8     |    9     |
num |   123    |    86    |   116    |   131    |    53    |    63    |    83    |    84    |    38    |    49    |

Epoch: 16
acc: 0.8199999928474426
Valid:
cls |    0     |    1     |    2     |    3     |    4     |    5     |    6     |    7     |    8     |    9     |
acc |  0.2000  |  0.5714  |  0.8143  |  0.7000  |  0.9857  |  0.9571  |  1.0000  |  0.9857  |  1.0000  |  0.9857  |
num |    26    |    63    |    84    |    88    |    77    |    73    |    71    |    74    |    72    |    72    |
Test:
prediction changing rate: 0.1361249219405563
cls |    0     |    1     |    2     |    3     |    4     |    5     |    6     |    7     |    8     |    9     |
num |    95    |   119    |   110    |   137    |    49    |    51    |    83    |    87    |    49    |    46    |

Epoch: 17
acc: 0.8385714292526245
Valid:
cls |    0     |    1     |    2     |    3     |    4     |    5     |    6     |    7     |    8     |    9     |
acc |  0.3286  |  0.6429  |  0.8571  |  0.6143  |  0.9857  |  0.9857  |  0.9857  |  1.0000  |  1.0000  |  0.9857  |
num |    35    |    72    |    76    |    73    |    75    |    79    |    70    |    70    |    73    |    77    |
Test:
prediction changing rate: 0.09926016499710152
cls |    0     |    1     |    2     |    3     |    4     |    5     |    6     |    7     |    8     |    9     |
num |    94    |   112    |   116    |   124    |    63    |    57    |    76    |    88    |    43    |    53    |

Epoch: 18
acc: 0.8057142496109009
Valid:
cls |    0     |    1     |    2     |    3     |    4     |    5     |    6     |    7     |    8     |    9     |
acc |  0.1571  |  0.5857  |  0.7714  |  0.6000  |  0.9714  |  1.0000  |  1.0000  |  0.9857  |  1.0000  |  0.9857  |
num |    20    |    74    |    79    |    74    |    73    |    81    |    78    |    72    |    74    |    75    |
Test:
prediction changing rate: 0.12770776092506547
cls |    0     |    1     |    2     |    3     |    4     |    5     |    6     |    7     |    8     |    9     |
num |    73    |   111    |   109    |   107    |    62    |    67    |   105    |    94    |    39    |    59    |
Finished Training
